NO ./texture/north.xpm
SO ./texture/south.xpm
WE ./texture/west.xpm
EA ./texture/east.xpm

C   255  ,   30 ,  0	

F   220,100,0


1111111
1010001
1100001
1100001
1000001
1000001
1000011
1000001
1000001
1000001
1000001
100S001
1000001
1111111
1111111
1000001
1111111
